11
7
1
3
7
3
1 2 1 2 2 5 4 1 2 0 1
4 0 3 3 2 0 0 1 2 0 1
1 0 0 0 2 0 0 0 0 1 3
1 1 0 1 1 0 1 2 0 2 3
1 1 3 2 1 0 1 0 0 3 1
1 1 2 1 0 0 2 0 3 1 2
1 2 5 4 0 1 2 3 2 3 1
